#####################################
#       # # #           #   #     # #
# ####### # ### # ### ### ####### # #
#   .   #       # #     #     # #   #
##### ##### ### # # # ### ##### # ###
#   # # # #   # # # #   # #   # #   #
# ### # # # ### ##### ### # ### ### #
#       #     #   #   #     # # #   #
### ######### ####### ### ### # # # #
#             #       # #   #     # #
# # ##### # ### # # ### # ### ### # #
# # #     # # # # #     #   # # # # #
# # # ####### # ######### ### # ### #
# # # #     #   #     #     #   #   #
### ### # ##### ##### ### ### ##### #
#     # # #  .  # #     # #   # # # #
# # # # # ### ### ### ### # # # # # #
# # # # #                 # # #     #
### ####### # # ##### ### # ### #####
#       # # # #     #   #     # #   #
##### # # ######### ########### # ###
#   # #           # # .   #   # #   #
# ### ##### ######### ##### # # ### #
# #   #      #        #     #       #
# # # ##### ### # # # # #############
# # #   #     # # # #       #   # # #
# # ### ### # # # ######### ### # # #
# #   # #   # # #   # #   # # #     #
# ### ### ##### ### # # ##### # #####
#       #   #  .  # #     #   # #   #
### # ##### ##### ### ### # ### # ###
# # # # # # # #     # #   # #  .# # #
# # ### # # # # ######### # # # # # #
#   #   #   #                 #     #
# # # # ### ### ####### ### ### ### #
#.# # #   .   #   #       #   # #  P#
#####################################