#############
#P          #
#           #
#          .#
#############