#########
#P##.   #
#  # # .#
# . .#.##
#########