###############
#    P........#
#    #.# # # ##
#     .#      #
#      #      #
###############